#############L#
#\.......... .#
##!##########.#
#R.#\.........#
###############
