#############L#
#\.......W.. .#
##!##########.#
#R.#\.........#
###############
