#############################################################################################
#L                                                                                          #
########################################################################################### #
#R \                                                                                        #
#############################################################################################
